NO textures/greystone.xpm
EA textures/greystone.xpm
WE textures/greystone.xpm
SO textures/greystone.xpm

F 220,100,0
C 225,30,0

11111
1E001
11111
